7
11
B
O
S
X
BBBBBBBBBBB
BBBBBOBOOSB
XOOOOBOOBBB
BBBBOBBOBBB
BOBOOOOOBBB
BOOOBOBOOOB
BBBBBBBBBBB